vhcs_table = Spanish
vhcs_language = Spanish
vhcs_languageSetlocaleValue = es_ES
encoding = iso-8859-1
 do not exist = no existe
 Has IP address that can not be managed from the destination reseller !<br>This user can not be moved! =  La dirección IP no puede ser asignada al distribuidor! <br>Este usuario no se puede mover!
 Has unlimited rights for a <b> =  Tiene ilimitados privilegios para <b>
 is exceeding limits for a <b> =  se ha excedido el límite de <b>
 Is exceeding limits for a <b> =  se ha excedido el límite de <b>
 Messages translated =  mensajes traducidos
 you are logged now as  =  se acaba de identificar como 
(Ex. domain-of-your-choice.com) = (Ej. dominio-que-usted-selecciono.com)
(Ex. EUR) = (Ej. EUR)
(usually named backup_YYY_MM_DD.tar) = <i>(Nombre usual de la copia de seguridad backup_YYY_MM_DD.tar)<i>
[New] = [Nuevo]
[Re] = [Re]
* denotes mandatory field. = * denotan campos obligatorios
&nbsp; = &nbsp;
</b> = </b>
</b> Address !<br>Edit reseller aborted! = </b> Dirección !<br>Edición distribuidor abortada!
</b> amount, present on the system! = </b> cantidad, presente en el sistema!
</b> in a destination reseller,<br> = </b> en un destino distribuidor,<br>
</b> In a destination reseller,<br> = </b> En un destino distribuidor,<br>
</b> records on the system! = </b> registros en el sistema!
</b> records, present on the system! = </b> registros. presentes en el sistema!
</b> Service !<br> = </b> Servicio !<br>
</b> Service can not be disabled !<br>There is <b> = </b> Servicio no puede ser deshabilitado !<br>Hay <b>
</b> Service can not be limited !<br>specified number is smaller then <b> = </b> Este servicio no se puede limitar !<br>el número especificado es inferior a <b>
</b> Service can not be limited !<br>Specified number is smaller then <b> = </b> Este servicio no se puede limitar !<br>El número especificado es inferior a <b>
</b> Service can not be limited !<br>You are exceeding reseller limits for the <b> = </b> Este servicio no se puede limitar !<br>Vd. ha rebasado los límites para distribuidores para <b>
</b> Service can not be unlimited !<br>There is reseller limits for the <b> = </b> Este servicio no puede ser ilimitado !<br>El distribuidor tiene un  límite <b>
</b> service! = </b> servicio!
</b><br> = </b><br>
<b>Routine maintenance!</b><br><br>VHCS is not available for system changes<br><br>Pleas contact your hosting service provider for more information<br><br>We apologize for any inconvenience and thank you for understanding = <b>Mantenimiento de rutina!</b><br><br>VHCS no está disponible para cambios en su sitema<br><br>Por favor contacte con su proovedor de hospedaje para mas información<br><br>Le rogamos nos disculpe por todos los inconvenientes y le agradecemos su comprensión
<b>Thank You for purchasing</b><br>You will receive an email with more details and information = <b>Gracias por comprar</b><br>Usted recibirá un email con más detalle e información.
<br>service in destination reseller!<br> = <br>servicio en destino distribuidor!<br>
0 = 0
1 = 1
2 = 2
3 = 3
4 = 4
Access your files through the web interface = Acceda a sus archivos mediante la interface Web
Access your mail through the web interface = Acceda a sus correos mediante la interface Web
Account name = Nombre de la cuenta
Action = Acción
Active = Activo
Acttive = Activo
Add = Añadir
Add admin = Añadir administrador
Add alias = Añadir alias
Add Cronjob = Añaidr Cronjob
Add domain alias = Añadir alias de dominio
Add existing user = Añadir usuario existente
Add FTP user = Añadir usuario FTP
Add group = Añadir grupo
Add hosting plan = Añadir un plan de hospedaje
Add mail user = Añadir usuario de correo
Add mail users = Añadir usuarios de correo
Add new button = Añadir un nuevo botón
Add new IP = Añadir una nueva IP
Add new protected area = Añadir nueva area protegida
Add new user hosting plan = Añadir un usuario nuevo al plan de hospedaje
Add On A Domain = Añadir un dominio
Add other domains to this account = Añaidr otros dominios a esta cuenta 
Add plan = Añadir plan
Add reseller = Añadir distribuidor
Add SQL database = Añadir base de datos MySQL
Add SQL user = Añadir usuario MySQL
Add subdomain = Añadir subdominio
Add to the system = Añadir al sistema
Add user = Añadir cliente
Add/Details = Añadir/Detalle
Addition in progress = Progreso de la adicción
Additional data = Datos adicionales
Admin log = Bitácora del administrador
Admin Log = Bitácora del administrador
Admin users = Usuarios del administrador
Administrator = Administrador
Administrators = Amministradores
Adminitrators list is empty! = Lista de administradores está vacia!
Alais name = Nombre del Alias del dominio
Alias = Alias
Alias forward = Redirección
Alias list is empty! = Lista de alias está vacia!
Alias list is empty! You can not add FTP accounts there! = Lista de alias está vacia! Usted no puede añadir cuentas de FTP!
Alias list is empty! You can not add mail accounts! = Lista de alias list está vacia! Usted no puede agregar cuentas de email!
Alias mail = Alias de correo
Alias mails = Alias de los correos
Alias name = Nombre del alias
Alias scheduled for addition! = Alias programado para adicionar!
Alias scheduled for deletion! = Alias programado para eliminar!
Alias scheduled for modification! = Alias programado para modificar!
Alias(es)<br><i>(-1 disabled, 0 unlimited) = Alias(es)<br><i>(-1 deshabilitado/s, 0 ilimitado/s)
Aliases = Aliases
All = Todo
All closed support tickets deleted successfully! = Todos los tickets cerrados han sido eliminados correctamente!
All in = Todo dentro
All open support tickets deleted successfully! = Todos los tickets abiertos han sido elimitados correctamente!
All out = Todo fuera
All resellers = Todos los distribuidores
All traffic = Todo el tráfico
All users & resellers = Todos los usuarios y distribuidores
All users = Todos los usuarios
Already in: = Ya existe en:
Apache logfiles = Archivos de Bitácora de Apache
Apache logs = Bitácoras de Apache
Apply changes = Aplicar cambios
Are you sure you want to change the status of domain account? = Está seguro de que quiere cambiar el estado de la cuenta de este dominio ?
Are you sure you want to delete = Está usted seguro que desea eliminar
Are you sure you want to delete this account? = Está usted seguro que desea eliminar esta cuenta?
Are you sure you want to delete this order? = Está usted seguro que desea eliminar esta orden?
Area name = Nombre del área
Assign = Asignar
Auto email template data updated! = La plantilla auto email actualizada!
Auto respond = Auto respuesta
Automatic Updates = Actualizaciones Automaticas
Available for purchasing = Disponible para comprar
Available IPs = IPs disponibles
Available VHCS updates = Disponible la actualización de VHCS
Awstats = Awstats
AwStats = AwStats
Back = Atrás
Backup / Restore = Copia de seguridad / Restauración
Backup = Copia de seguridad
Backup and restore = Copia de seguridad y restauración
Backup and Restore = Copia de seguridad y restauración
Backup and restore settings = Configuración de la copia de seguridad y restauración
Backup archive scheduled for restoring! = El archivo de backup programado para restaurar!
Behind the name = Detrás del nombre
Billing Settings = Configuración de Pago
Blue = Azul
Button link = Enlace del botón
Button name = Nombre del botón
Button target = Destino (_top, _blank)
Can not connect as MySQL administrator! = No puedo conectarme como administrador MySql!
Can Not Connect As MySQL Administrator! = No Puedo Conectarme Como administrador MySql!
Can not open directory !<br>Please contact your administrator ! = No se puede abrir el directorio !<br>Por favor contacte con el administrador !
Can not open file! Please contact your administrator ! = No puedo abrir el archivo! Contactase con su administrador !
Can not read vhcs language file! = No puedo leer el archivo de lenguaje vhcs.
Cancel = Cancelar
Cancel order = Cancelar orden
Cannot connect as MySQL administrator! = no puedo conectarme como administrador MySql 
Catch all = Por defecto
Catch all account = Cuenta por defecto
Catch all account scheduled for creation! = La cuenta por defecto está programada para su creación!
Catch all account scheduled for deletion! = La cuenta por defecto está programada para su eliminación!
Catch all mail account can not be created! = La cuenta de correo por defecto no se ha podido crear!
CGI / Perl = CGI / Perl
CGI support = Soporte CGI
CGI Support: disabled = CGI Support: deshabilitado
CGI Support: enabled = CGI Support: habilitado
Change = Identificarse como
Change password = Modificar contraseña
Change pers. data = Modificar datos personales
Change personal data = Modificar datos personales
Change SQL user password = Modificar usuario MySQL
Change user interface = Modificar interface de usuario
Check Out = Finalizar Compra
Choose = Seleccione
Choose default language = Elija el idioma por defecto
Choose default layout = Elija el idioma por defecto
Choose dir = Seleccione directorio
Choose hosting plan = Elija el plan de hospedaje
Circular = Circolare
City = Ciudad
Clear log = Limpiar bitácoras
Click Restore button and the system will<br>restore last daily backup = Pulse Restaurar para regenerar el sistema<br>con la última copia de seguridad
Close ticket = Cerrar ticket
Closed tickets = Tickets cerrados
Command to run: = Comando a ejecutar: 
Company = Empresa
Continue = Continuar
Core data = Datos Principales
Costs = Costo 
Country = País
CPU bogomips = CPU bogomips
CPU cache = CPU cache
CPU MHz = CPU MHz
CPU model = Modelo de la CPU
CPU system Info = Información del sistema de la CPU
Create catch all = Crear cuenta por defecto
Create catch all mail account = Crear cuenta de correo por defecto
Created by = Creado por
Creation date = Fecha de creación
Cronjob = Tarea Programada
Cronjob Manager = Manejador de Tareas Programadas
Cronjobs = Tareas Programadas
Currency = Moneda
Current password = Contrase–a actual
Custom Apache Logs = Logs de apache
Custom error page was updated! = Página de error ha sido actualizada!
Custom error pages = Personalización de los errores de las páginas
Custom Error Pages = Personalización de los errores de las páginas
Custom menu data updated successful! = Menú personalizado fue actualizado correctamente!
Custom menu deleted successful! = Menú personalizada fue eliminado correctamente!
Custom menus = Menús personalizados
Customer data = Datos del cliente
Customer ID = Cliente ID
Customer order was removed successful! = Orden del ciente fue eliminada correctamente!
Customize error pages for your domain = Personalice los errores de las páginas en sus dominios
D = Detalles
Daily backup = Copia de seguridad diaria
Database list is empty! = Lista de base de datos está vacia!
Database name = Nombre de la base de datos
Database user list is empty! = Lista de usuarios de base de datos está vacia!
Database users = Usuarios de la base de datos
Date = Fecha
Day = Dia
Day: = Día:
Day(s): = Dia(s): 
default = por defecto
Default = Por defecto
Default language changed! = Lenguaje por defecto cambiado!
delete = eliminar
Delete = Eliminar
Delete all = Eliminar todo
Delete CatchAll = Eliminar por defecto
Delete order = Eliminar orden
Deletion in progress = Eliminación en progreso
Description = Descripción
Details = Detalles
Direction download today backup = Dirección actual de la descarga de la copia de seguridad
Directories = Directorios
Directory listing = Directorio de la lista
Directory mount point = Directorio del punto de montaje
Directory tree = Arbol del directorio
Directory tree<br>mount point = Arbol del directorio<br>punto de montaje
Disable = Deshabilitado
disabled = deshabilitado
Disabled = deshabilitado
Disk [MB]<br><i>(0 unlimited) = Disco [MB]<br><i>(0 ilimitado)
Disk = Disco
Disk in MB = Disco en MB
Disk limit [Mb]<br><i>(0 unlimited)</i> = Límite del disco [Mb]<br><i>(0 ilimitado)</i>
Disk limit [MB]<br><i>(0 unlimited)</i> = Límite del disco [MB]<br><i>(0 ilimitado)</i>
Disk usage = Uso del Disco
Disk<br>usage = Uso del<br>disco
Domain = Dominio
Domain account = Cuenta del dominio
Domain alias = Alias de dominio
Domain alias added for termination! = Alias de dominio añadido para eliminación!
Domain alias added! = Alias de dominio añadido!
Domain alias errors = Errores en el alias del dominio
Domain alias limit expired! = Limite de alias de dominio excedido!
Domain alias modified! = Alias de dominio modificado!
Domain alias not added for termination! = Alias de dominio no añadido para eliminación!
Domain alias not added! = Alias de dominio no añadido!
Domain alias not modified! = Alias de dominio no modificado!
Domain alias you are trying to remove has email accounts !<br>First remove them! = El alias del dominio que quiere eliminar dispone de cuentas de correo !<br>Elimínelas primero !
Domain alias you are trying to remove has FTP accounts!<br>First remove them! = El Alias de dominio que usted está tratando de eliminar tiene cuentas FTP!<br>Primero eliminelas!
Domain aliases = Alias de dominio
Domain aliasses = Aliases de dominio
Domain details = Detalles del doinio
Domain errors = Erores de dominio
Domain Features = Caracteristicas del dominio
Domain IP = IP del dominio
Domain mail = Cuenta de correo del dominio
Domain mails = Correos del dominio
Domain name = Nombre del dominio
Domain properties = Propiedades del dominio
Domain properties updated successfully! = Propiedades del dominio fueron actualizadas correctamente!
Domain statistics = Estadísticas del dominio
Domain with that name already exists on the system! = El dominio con este nombre ya existe en el sistema!
Domain with this name already exist = Ya existe un dominio con ese nombre
Domain you are trying to remove has domain alias!<br> first remove them ! = El dominio que trata de eliminar tiene asignado alias de dominio !<br>Elimínelos primero !
Domain you are trying to remove has email accounts !<br> first remove them ! = El dominio que trata de elminar tiene cuentas de correo !<br> Elimínelas primero !
Domain you are trying to remove has FTP accounts !<br> first remove them ! = El dominio que trata de elminar tiene cuentas FTP !<br> Elimínelas primero !
Domain you are trying to remove has subdomains accounts !<br> first remove them ! = El dominio que trata de eliminar tiene asignado cuentas de subdominios !<br>Elimínelos primero !
Domains = Dominios
Done = Hecho
Download the only one file in this directory = Solo puede descargar un solo archivo en este directorio
E-mail = Correo electrónico
Edit = Modificar
Edit admin = Modificar administrador
Edit button = Modificar botón
Edit Cronjob = Modificar Tarea Programadas
Edit Domain = Modificar dominio
Edit domain alias = Modificar alias del dominio
Edit email account = Modificar cuenta de correo
Edit error page = Modificar error de página
Edit FTP user = Modificar usuario FTP
Edit hosting plan = Modificar plan de hospedaje
Edit mail auto responder = Modificar auto responder mail
Edit properties = Editar propiedades
Edit reseller = Modificar distribuidor
Edit reseller aborted! = Modificar distribuidor abortada!
Edit user = Modificar usuario
Email = Correo
Email account not founded! = Cuenta de email no encontrada!
Email Accounts = Cuentas de Email
Email and FTP accounts = Cuentas de correo y FTP
Email forward = Desviación de correo
Email marketing = Correo de contacto
Email setup = Configuración del correo
Email Updated = Actualización del correo
Email Updated! = Email Modificado!
Empty data or wrong field! = datos vacios o campo incorrecto!
Empty list = Lista vacía
Empty List = Lista Vacía
Enable = Habilitado
Enable mail auto responder = Auto contestador de correo habilitado
enabled = habilitado
Enabled = habilitado
Enduser level = Nivel del usuario final
Enter Address = Ingrese dirección
Entered passwords differ from the another! = Contraseña ingresadas difieren!
Entered passwords differ! = Contraseña ingresadas difieren!
Entered passwords does not match! = Contraseña ingresadas no coinciden!
Error = Error
Error 401 (unauthorized) = Error 401 (no autorizado)
Error 403 (forbidden) = Error 403 (permiso denegado)
Error 404 (not found) = Error 404 (no encontrado)
Error 500 (internal server error) = Error 500 (error interno)
Error pages = Paginas de error
Error we have domain that use this IP! = Error tenemos un dominio que usa esa IP!
Error we have reseller that use this IP! = Error tenemos un distribuidor que usa esa IP!
ERROR: Password not send = ERROR: Contraseña no enviada
ERROR: Security code was not correct! = ERROR: Código de seguridad no es correcto!
ERROR: Unknown user = ERROR: Usuario desconocido
Execute = Ejecutar
Execute query = Ejecutar consulta
Execute SQL query = Ejecutar solicitud SQL
Existing SQL users = Usuarios SQL existentes
Export = Exportar
Extras = Extras
Fax = Fax
Feature = Característica
Filemanager = Manejo de archivos
Filesystem system Info = Información del sistema de archivos
First name = Nombre
Footer = Pie
Forward = Redirigir
Forward list is empty! = Lista de redirecciones está vacia!
Forward mail = Redirección de correo
Forward to = Redirigir a
Forward to URL = Redirigir a URL
Free = Libre
free of charge = libre de cargos
From = Desde
From reseller = Desde el distribuidor
Fronpage extensions = Extensiones de Frontpage
FTP = FTP
FTP account = Cuenta FTP
FTP account added! = Cuenta FTP añadida!
FTP account already exists! = Cuenta FTP ya existe!
FTP account data updated! = Cuenta FTP actualizada!
FTP account deleted successfully! = Cuenta FTP fue eliminada correctamente!
FTP account limit<br><i>(0 unlimited)</i> = Límite de la cuenta FTP<br><i>(0 ilimitado)</i>
FTP account(s)<br><i>(0 unlimited) = Cuentas FTP<br><i>(0 ilimitado)
FTP accounts = Cuentas FTP
FTP Accounts = Cuentas FTP
FTP accounts limit expired! = Cuentas FTP excedidas!
FTP list is empty! = Lista FTP está vacia!
FTP traffic = Tráfico FTP
FTP users = Usuarios FTP
FTP<br>traffic = Tráfico<br>FTP
FTPs total = Total FTPs
General information = Información General
Go back = Volver atrás
Green = Verde
Group = Grupo
Group already exist ! = Grupo existente!
Group auth = Identificación de grupos
Group members = Miembros del grupo
Group name = Nombre del grupo
Groups = Grupos
Has unlimited rights for a <b> = Tiene ilimitados privilegios para <b>
Havent you got more than one name? = No tiene mas de un nombre?
Havent you got more then one name? = No tiene mas de un nombre?
HDD = HDD
Header = Encabezado
hide aliases = esconder alias
High = Alto
Host = Host
Hosting details = detalles del hospedaje
Hosting plan = Plan de hospedaje
Hosting plan added! = Plan de hospedaje añadido!
Hosting plan deleted! = Plan de hospedaje eliminado!
Hosting plan properties = Propiedades del plan de hospedaje
Hosting plan updated! = Plan de hospedaje actualizado!
Hosting plan with entered name already exists! = El plan de hospedaje ya existe!
Hosting plans = Planes de hospedaje
Hosting plans available for update = Planes de hospedaje disponibles para actualizar
Hosting plans not found! = Planes de hospedaje no encontrado!
Hour = Hora
Hour(s): = Hora(s):
ID = ID
If you want to limit the reseller, fist you must limit its users !<br> = Si usted quiere restringir los privilegios del distribuidor debe limitar en primer lugar los de los clientes asociados a este !<br>
Imagecode description = Descrición Imagecode
Implementation URL = Implementación URL
In front the name = Delante el nombre
Incorrect alias range or syntax! = El valor del alias no es correcto!
Incorrect city syntax! = El valor de la ciudad no es correcto!
Incorrect company range or syntax! = El rango de la compañia no es correcto!
Incorrect country syntax! = El pais no es correcto!
Incorrect customer ID syntax! = EL ID del cliente no es correcto!
Incorrect data input! = Los datos son incorrectos!
Incorrect disk range or syntax! = El rango de disco no es correcto!
Incorrect domain name syntax = El nombre de dominio no es correcto!
Incorrect email range or syntax! = El email no es correcto!
Incorrect fax range or syntax! = El fax no es correcto!L
Incorrect first name range or syntax! = El primero nombre no es correcto!
Incorrect forward syntax = La redirección no es correcta!
Incorrect FTP account range or syntax! = El valor de la  cuenta FTP no es correcto !
Incorrect mail account range or syntax! = El valor de la cuenta de correo no escorrecto !
Incorrect max alias count or syntax! = El máximo de alias no es correcto!
Incorrect max disk amount or syntax! = El máximo de espacio en disco no es correcto!
Incorrect max domain count or syntax! = El máximo de dominios no es correcto!
Incorrect max FTP count or syntax! = el valor máximo de cuentas FTP no es correcto!
Incorrect max mail count or syntax! = El máximo de cuentas de email no es correcto!
Incorrect max SQL databases count or syntax! = El máximo de base de datos no es correcto!
Incorrect max SQL users count or syntax! = El máximo de usuarios de base de datos no es correcto!
Incorrect max subdomain count or syntax! = El máximo de subdominios no es correcto!
Incorrect max traffic amount or syntax! = La capacidad máxima de tráfico no es correcta !
Incorrect mount point syntax = El punto de montaje no es correcto!
Incorrect password range or ayntax! = La contraseña no es correcta!
Incorrect password range or syntax! = La contraseña no es correcta!
Incorrect phone range or syntax! = El teléfono no es correcto!
Incorrect post code range or syntax! = El código postal no es correcto!
Incorrect price range or syntax! = El precio no es correcto!
Incorrect second name range or syntax! = El segundo nombre no es correcto!
Incorrect setup fee range or syntax! = El cargo de instalación no es correcto!
Incorrect SQL database range or syntax! = La base de datos no es correcta!
Incorrect SQL user range or syntax! = El usuario de base de datos no es correcta!
Incorrect street 1 syntax! = La dirección 1 no es correcta!
Incorrect street 2 syntax! = La dirección 2 no es correcta!
Incorrect subdomain range or syntax! = El subdominio no es correcto!
Incorrect template description range or syntax! = La descripción de la plantilla no es correcto!
Incorrect template name range or syntax! = El valor del mombre de la plantilla no es correcto !
Incorrect traffic range or syntax! = El tráfico no es correcto!
Incorrect username range or syntax! = El usuario no es correcto!
Install = Instalar
Install new language = Instalado nuevo Idioma
Installed languages = Idiomas instalados
Installed layouts = Layouts Instalados
IP = Dirección IP
IP was deleted! = IP eliminada!
JSP = JSP
Kernel = Kernel
Kill session = Matar session
Label = Etiqueta
Language = Idioma
Language file = Archivo de Idioma
Last access = Ültimo acceso
Last name = Apellido
Last reply = Última réplica
Layout = Configuración del Layout
Layout name = Nombre del Layout
Layout settings = Configuración del Layout
Level = Nivel
Limit = Límite
Load = Cargar
Log is empty! = La bitácora está vacía!
Login = Identificación
Login with your FTP account = Identificación con su cuenta FTP
Logo file = Archivo para el logotipo
Logo upload = El logotipo se ha cargado
Logout = Salir de la identificación
Lost password = Recuperar contraseña
Lostpw email = Lostpw email
Lostpw email setup = Configuración Lostpw email 
Lostpw link = Enlace Lostpw
Lostpw message 1 = Mensaje lostpw 1
Lostpw message 2 = Mensaje lostpw 2
Low = Bajo
Mail = Correo electrónico
Mail account = Cuenta de correo
Mail account already exists! = Cuenta de email existente!
Mail account errors = Errores de la cuenta de correo
Mail account limit<br><i>(0 unlimited)</i> = Límite para la cuenta de correo<br><i>(0 ilimitada)</i>
Mail account scheduled for addition! = Cuenta de email programada para adicionar!
Mail account scheduled for modification! = Cuenta de email programada para modificar!
Mail account scheduler for modification! = Cuenta de email programada para modificar!
Mail account(s)<br><i>(0 unlimited) = Cuentas(s) de email<br><i>(0 ilimitada)
Mail accounts = Cuentas de correo
Mail accounts limit expired! = Cuentas de email excedidas!
Mail accounts list = Listas de cuentas de correo
Mail accounts list is empty! = Lista de cuentas de email está vacia!
Mail forward list error! = Error lista de redirecciones de email!
Mail in = Correo activo
Mail out = Correo inactivo
Mail users = Usuarios de correo
Mail were updated successfully! = Cuenta de email fue actualizada correctamente!
Mails total = Total correos
Main domain = Dominio principal
Manage alias = Gestiona de alias
Manage custom menus = Gestion de menús personalizados
Manage domain alias = Gestion de alias de dominio
Manage domains = Gestion de dominios
Manage hosting plans = Gestion de planes de hospedaje
Manage IPs = Gestion de IPs
Manage orders = Administrar ordenes
Manage Orders = Administrar Ordenes
Manage protected areas, users and groups = Administrar areas protegidas, usuarios y grupos
Manage SQL = Gestion de bases de datos MySQL
Manage user = Administrador usuarios
Manage user sessions = Administrar sessiones de usuarios
Manage users = Gestion de usuarios
Manage users and groups = Administrar usuarios y grupos
Mark = Marca
Max aliases count = Número máximo de aliases
Max aliases count<br><i>(0 unlimited)</i> = Número máximo de aliases<br><i>(0 ilimitados)</i>
Max aliases<br><i>(-1 disabled, 0 unlimited) = Máximos aliases<br><i>(-1 deshabilitados, 0 ilimitados)
Max disk amount [MB] = Máxima capacidad de disco [MB]
Max disk amount [MB]<br><i>(0 unlimited)</i> = Máxima capacidad de disco [MB]<br><i>(0 ilimitado)</i>
Max domain count = Máximo número de dominios
Max Domain count = Máximo número de Dominios
Max domain count<br><i>(0 unlimited)</i> = Máximo número de dominios<br><i>(0 ilimitados)</i>
Max FTP users count = Máximo número de usuarios FTP
Max FTP users count<br><i>(0 unlimited)</i> = Máximo número de usuarios FTP<br><i>(0 ilimitados)</i>
Max mail users count = Máximo número de usuarios de correo
Max mail users count<br><i>(0 unlimited)</i> = Máximo número de usuarios de correo<br><i>(0 ilimitados)</i>
Max SQL databases count = Máximo número de bases de datos SQL
Max SQL databases count<br><i>(-1 disabled, 0 unlimited)</i> = Máximo número de bases de datos SQL<br><i>(-1 deshabilitadas, 0 ilimitadas)
Max SQL users count = Máximo número de usuarios SQL
Max SQL users count<br><i>(-1 disabled, 0 unlimited)</i> = Máximo número de usuarios SQL<br><i>(-1 deshabilitados, 0 ilimitados)
Max subdomain count = Máximo número de subdominios
Max subdomain count<br><i>(0 unlimited) = Máximo número de subdominios<br><i>(0 ilimitados)
Max subdomains<br><i>(-1 disabled, 0 unlimited) = Máximos subdominios<br><i>(-1 deshabilitados, 0 ilimitados)
Max traffic [MB] = Tráfico máximo [MB]
Max traffic amount [MB] = Máximo tráfico autorizado [MB]
Max traffic amount [MB]<br><i>(0 unlimited)</i> = Máximo tráfico autorizado [MB]<br><i>(0 ilimitado)</i>
Medium = Medio
Memory system info = Información de la memoria del sistema
Menu button = Botón de menú
Message = Mensaje
Message subject = Asunto del mensaje
Message template = Plantilla del mensaje
Message template info = Información de la plantilla del mensaje
Message was send! = Mensaje enviado!
Message was sent. = El mensaje fue enviado!
Messages = Mensajes
Minute(s): = Minuto(s): 
Missing or incorrect data input! = Dato incorrecto!
Missing or wrong data! = Dato incorrecto!
Modification in progress = Modificación en progreso
Modify = Modificar
Month = Mes
Month: = Mes:
Months(s): = Mes(es): 
Mount = Montaje
Mount point = Punto de Montaje
Move = Mover
Moving aborted! = Mover abortada!
Multilanguage = Multiidioma
MySQL support = Soporte MySQL
N/A = N/A
Name = Nombre
new = nuevo
New = Nuevo
New IP was added! = Nueva IP añadida!
New language installed! = Nuevo lenguaje instalado!
New order = Nueva orden
New ticket = Nuevo tiket
New VHCS update is now available = Una nueva versión de VHCS está disponible!
Next step = Siguiente paso
no = no
No = no
No available hosting packages = No hay paquetes de hospedaje disponibles
No domain alias system errors = No existen errores del sistema para el alias del dominio
No domain system errors = No existen errores del sistema para el dominio
No email account system errors = No existen errores del sistema en la cuenta de email
No new messages = No hay mensajes nuevos
No new VHCS updates available = No hay actualizaciones disponibles pra VHC
No subdomain system errors = No existen errores del sistema para el subdominio
No. = No.
None = Ninguno
Normal mail = Correo normal
Normal users = Usuarios normales
Not found reseller(s) in your system! = No se encuentra distribuidor(es) en el sistema!
Not found user records matching the search criteria! = No hay ningún registro de  usuario que cumpla su  criterio de  búsqueda!
Not in: = No en: 
Number = Dirección IP
of = de
ok = Ok
Ok = Ok
OK = Ok
Open ticket = Abrir ticket
Open tickets = Tickets abiertos
Options = Opciones
Order = Orden
Order data updated successfully! = Orden fue actualizada correctamente!
Order date = Fecha orden
Order details = Detalle orden
Order email setup = Email orden
Order settings = Caracteristicas orden
Other in = Otro activo
Other out = Otro inactivo
Overview = Vista General
Owner = Propietario
Package Features = Caracteristicas del paquete
Package Price = Precio del paquete
Parent Directory = Directorio anterior
Partition = Partición
Password (repeat) = Contraseña (repetir)
Password = Contraseña
Password data = Datos de la contraseña
Password data is missing! = Contraseña incorrecta!
Password not match! = Contraseña no coinciden!
Password repeat = Repita la contraseña
Password send = Contraseña enviada
Password(repeat) = Contraseña(repetir)
Passwords does not match! = Las contraseñas no coincen!
Path = Camino
Payment period = Periodo de pago
Percent = Porciento
Performance = Rendimiento
Permission deny! = Permiso denegado!
Personal data = Datos personales
Personal Data = Datos personales
Personal data updated successfully! = Datos personales fueron actualizados correctamente!
Personalize template = Personalice la plantilla
Phone = Teléfono
PHP = PHP
PHP support = Soporte PHP
PHP Support: disabled = Soporte PHP: deshabilitado
PHP Support: enabled = Soporte PHP: habilitado
PhpMyAdmin = PhpMyAdmin
Please choose user or group = Por favor seleccione usuario o grupo
Please delete first CatchAll account for this email! = Por favor eliminar primero todo correo predeterminado de este email!
Please enter area name = Por favor introduzca el nombre del  área
Please enter area path = Por favor introduzca el camino
Please enter FTP account username! = Por favor introduzca el usuario FTP!
Please enter mail account username! = Por favor introduzca el usuario de email!
Please enter SQL query! = Por favor introduzca la consulta SQL!
Please fill out all needed fields! = Por favor introduzca todos los campos necesarios!
Please fill up all data fields! = Por favor complete todos los campos!
Please fill up both data fields for password! = Por favor introduzca los dos campos para la contraseña!
Please fill up both data fields! = Por favor introduzca los dos campos!
Please select some user(s)! = Por favor seleccione algun usuario!
Please specify a message content! = Por favor seleccione un contenido!
Please specify a message subject! = Por favor seleccione un asunto!
Please specify a sender email! = Por favor seleccione un email destinatario!
Please specify a sender name! = Por favor seleccione el nombre destinario!
Please specify a subject! = Por favor seleccione el asunto!
Please specify alias! = Por favor seleccione un alias!
Please specify domain! = Por favor seleccione un dominio!
Please specify email address! = Por favor seleccione una dirección de email!
Please specify message subject! = Por favor seleccione el asunto!
Please specify message! = Por favor seleccione el mensaje!
Please specify other FTP account dir! = Por favor seleccione otra directorio para la cuenta de FTP!
Please specify sender name! = Por favor seleccione el nombre de destinatario!
Please specify some email address! = Por favor seleccione algunas direcciones de emails!
Please specify some message! = Por favor seleccione algún mensaje!
Please specify some sender name! = Por favor seleccione algún nombre de destinatario!
Please specify subdomain name! = Por favor seleccione un nombre de subdominio!
Please type database name! = Por favor ingrese un nombre de base de dato!
Please type user name! = Por favor ingrese un nombre de usuario!
Please type user password! = Por favor ingrese una contraseña para el usuario!
Please type your mail autorespond message! = Por favor ingrese su mensaje de autorespuesta!
Please type your message! = Por favor ingrese su mensaje!
POP/IMAP = POP/IMAP
Pop/IMAP in = Pop/IMAP in
Pop/IMAP out = Pop/IMAP out 
POP3/IMAP traffic = POP3/IMAP traffic
POP3/IMAP<br>traffic = POP3/IMAP<br>traffic
Preview = Vista premilinar
Price = Precio
Priority = Prioridad
Protect it = Protéjalo
Protect this area = Proteja este área
Protected area created successfully! = Area protegida fue creada correctamente!
Protected area deleted successfully! = Area protegida fue eliminada correctamente!
Protected area status should be OK if you wannt to delete it! = El estado del area protegida debería estar OK si usted quiere eliminarla!
Protected area status should be OK if you wannt to edit it! = El estado del area protegida debería estar OK si usted quiere modificarla!
Protected area updated successfully! = Area protegida fue actualizada correctamente!
Protected area was deleted successful! = El área protegida se ha eliminado correctamente!
Protected areas = Áreas protegidas
Protected Areas = Áreas protegidas
Purchase = Comprar
Purchasing = Comprando
Query result = Resultado de la petición
Query status = Estado de la petición
RAM = RAM
Real domain = Dominio real
Red = Rojo
Remove = Eliminar
Request password = Solicitar contraseña
Reseller = Distribuidor
Reseller added = Añadido distribuidor
Reseller and enduser level = Nivel de distribuidor y usuario final
Reseller assignment = Distribuidor asignado
Reseller IP list is empty! = Lista de IP del distribuidor está vacia!
Reseller IPs = IPs del distribuidor
Reseller level = Nivel de distribuidor
Reseller list is empty! = Lista de distribuidos está vacia!
Reseller name = Nombre del distribuidor
Reseller or user list is empty! = Lista de distribuidore o usuarios está vacia!
Reseller statistics = Estadísticas del distribuidor
Reseller statistics table = Tabla estadística del distribuidor
Reseller users = Usuarios del distribuidor
Reseller users table = Tabla de usuarios del distribuidor
Resellers = Distribuidores
Resellers list is empty! = Lista de distribuidores está vacia!
Reset = Resetear
Restore = Restaurar
Restore backup = Restaurar copia de seguridad
Retry = Reintentar
Return to previous menu = Volver al menú previo
S = Estado
Save = Salvar
Save changes = Salvar cambios
Search = Buscar
Security code = Código de seguridad
Send message = Enviar mensaje
Send message reply = Contestar el mensaje enviado
Send message to = Enviar mensaje a
Send reply = Enviar contestación
Senders email = E-Mail de los remitentes
Senders name = Nombre del remitente
Server day statistics = Estadísticas diarias del servidor
Server error - please choose error page = Error del servidor - Por favor seleccione la página del error
Server statistics = Estadísticas del servidor
Server status = Estado del servidor
Server traffic = Tráfico del servidor
Server traffic settings = Configuración del tráfico del servidor
Server traffic settings updated successfully! = Configuración del tráfico del servidor fueron actualizadas correctamente!
Service = Servicio
Service in destination reseller!<br> = Servicio en destino distribuidor!
Set server traffic settings = Preparar la configuración del tráfico del servidor
Setup fee = Cargo de instalación
Setup Fee = Cargo de Instalación
Show = Mostrar
Show in = Mostrar en
Size = Dimensiones
SMTP = SMTP
SMTP traffic = Tráfico SMTP
SMTP<br>traffic = Tráfico<br>SMTP
Source and destination reseller are the same! = La fuente y el destino del distribuidor son el mismo
Specified database name already exists! = La base de datos especificada existe!
Specified SQL username name already exists! = El usuario SQL existe!
SQL accounts limit expired! = Cuentas SQL excedidas!
SQL database = Base de datos SQL
SQL Database = Base de datos SQL
SQL database created successfully! = Base de datos fue creada correctamente!
SQL database was removed successfully! = Base de datos fue eliminada correctamente!
SQL database(s)<br><i>(-1 disabled, 0 unlimited) = Base de datos SQL<br><i>(-1 deshabilitada, 0 ilimitada)
SQL databases = Bases de datos SQL
SQL databases limit<br><i>(-1 disabled, 0 unlimited)</i> = Límite de las bases de datos SQL<br><i>(-1 deshabilitadas, 0 ilimitadas)</i>
SQL databases Limit<br><i>(-1 disabled, 0 unlimited)</i> = Límite de las bases de datos SQL<br><i>(-1 deshabilitadas, 0 ilimitadas)</i>
SQL query = MySQL Query
SQL query has error = La petición SQL es erronea !
SQL query is ok = La petición SQL es correcta
SQL support = Soporte MySQL
SQL user = Usuario MySQL
SQL User = Usuario MySQL
SQL user name = Nombre del usuario MySQL
SQL user password was successfully changed! = La contraseña del usuario MySQL se ha modificado correctamente !
SQL user successfully added! = Usuario SQL fue añadido correctamente!
SQL user was removed successfully! = Usuario SQL fue eliminado correctamente!
SQL user(s)<br><i>(-1 disabled, 0 unlimited) = Usuario/s SQL<br><i>(-1 deshabilitado/s, 0 ilimitado/s)
SQL users = Usuarios SQL
SQL users limit<br><i>(-1 disabled, 0 unlimited)</i> = Límite del usuario SQL<br><i>(-1 deshabilitado, 0 ilimitado)</i>
SQL-user limit expired! = El límite de usuarios MySql se ha sobrepasado !
SQL<br>database = Base de datos<BR>SQL
SQL<br>user = Usuario<BR>SQL
SSI = SSI
Statistics = Estadísticas
Stats = Estad.
Status = Estado
Street 1 = Dirección 1
Street 2 = Dirección 2
Subdomain = Subdominio
Subdomain already exists! = Subdominio ya existe!
Subdomain data = Datos del subdominio
Subdomain errors = Errores del subdomnio
Subdomain forward = Redirección del subdomnio
Subdomain limit expired! = Subdominios excedidos!
Subdomain list is empty! = Lista de Subdominios está vacia!
Subdomain list is empty! You can not add FTP accounts there! = Lista de subdominios está vacia! Usted no puede agregar cuentas FTP!
Subdomain list is empty! You can not add mail accounts! = Lista de subdominios está vacia! Usted no puedo agregar cuentas de email!
Subdomain mail = Correo del subdominio
Subdomain mails = Correo del subdominio
Subdomain mount point already exists! = El punto de montaje del subdominio existe!
Subdomain name = Nombre del subdominio
Subdomain scheduled for addition! = Subdominio está programado para adicionar!
Subdomain scheduled for deletion! = Programada la eliminación del subdomnio !
Subdomain you are trying to remove has email accounts !<br>First remove them! = El subdominio que est‡ tratando de eliminar tiene cuentas de emails !<br>Primero eliminelas
Subdomain you are trying to remove has FTP accounts !<br>First remove them ! = El subdominio que est‡ tratando de eliminar tiene cuentas de FTP !<br>Primero eliminelas 
Subdomain(s)<br><i>(-1 disabled, 0 unlimited) = Subdominio/s<br><i>(-1 deshabitlitado/s, 0 ilimitado/s)
Subdomains = Subdominios
Subject = Asunto
Submit changes = Cambios en el asunto
Sum = Suma
support question(s) = pregunta soporte(n)
Support question(s) = Pregunta Soporte(n)
support questions = preguntas soporte
Support system = Sistema de soporte
Support ticket deleted successfully! = el ticket se ha eliminado correctamente !
Support tickets = Soporte (tickets)
suspended = suspendido
Suspended = Suspendido
Swap = Intercambio
Switch to backup directory = Cambiar al directorio de la copia de seguridad
System error - custom error page was NOT updated! = Error del Sistema - La página de errores personalizados NO se ha actualizado!
System error with Doman ID  = Error del sistema con ID de dominio
System info = Información del sistema
System messages = Mensajes del sistema
System tools = Herramientas del sistema
Template name = Nombre de la plantilla
The current password is wrong! = La contrase–a actual es incorrecta!
The password was requested = La contraseña fue solicitada
Theme color = Color del tema
Then the value you are trying to enter now !<br> = Introduzca de nuevo el valor !<br>
Then the value you are trying to enter now!<br> = Intrduzca de nuevo el valor !<br>
There are alias with same mount point = Existen alias con el mismo punto de montaje
There are no available hosting plans for update = No existen planes de hospedaje para actualizar
There are no available updates = No hay actualizaciones disponibles
This IP already exist! = El IP ya existe!
This reseller has already dispatched more <b> = Este distribuidor ya ha sido enviado<b>
This reseller has domains assigned To <b> = Este distribuidor tiene dominiuos asignados a <b>
This reseller has more <b> = Este distribuidor tiene mas <b>
This reseller has no domains yet. = El distribuidor no tiene dominios todavia.
This reseller has no domains. = El distribuidor no tiene dominios.
This reseller has user(s) with unlimited rights for <b> = Este distribuidor tiene usuario/s con privilegios ilimitados para <b>
This user has domain record !<br>First remove the domain from the system! = El usuario tiene un dominio registrado!<br>Primero elimine el dominio del sistema!
This user have domain !<br>To delete user  - first delete domain! = El usuario tiene un dominio !<br> Para eliminar el usuario - primero elimine el dominio!
This user name already exist! = El usuario ya existe!
Ticket not found! = Ticket no encontrado!
Ticket was closed! = Ticket cerrado!
Ticket(s) are closed! = Ticket(s) cerrados!
Ticket(s) are deleted! = Ticket(s) eliminados!
To Admin = Para el administrador
To domain alias = Para el alias del dominio
To main domain = Para el dominio principal
To reseller = Para el distribuidor
To subdomain = Para el subdominio
Too long database name! = Nombre de base de datos demasiado largo!
Too long user password! = Contraseña de usuario demasiado larga !
Too user long password! = Contraseña de usuario demasiado larga !
Total = Total
Traffic [MB]<br><i>(0 unlimited) = Tráfico [MB]<br><i>(0 ilimitado) 
Traffic = Tráfico
Traffic accounting for the selected month is missing! = El tráfico del mes seleccionado no se encuentra!
Traffic in MB = Tráfico en MB
Traffic limit [Mb]<br><i>(0 unlimited)</i> = Límite de tráfico [Mb]<br><i>(0 ilimitado)</i>
Traffic limit [MB]<br><i>(0 unlimited)</i> = Límite de tráfico [MB]<br><i>(0 ilimitado)</i>
Traffic usage = Consumo de tráfico
Traffic<br>usage = Consumo de<br>tráfico
Type = Tipo
Undefined reference to data! = Referencia de datos indefinida!
Undefined user accounting error! = Cuenta de usuario indefinida!
uninstall = desinstalar
Uninstall = Desinstalar
Unknown = Desconocido
unknown status = Estado desconocido
Unknown type = Tipo desconocido
unlimited = ilimitado
Unprotect it = Desprotegido
Up time = Tiempo conectado
Update = Actualización
Update data = Actualizar datos
Update details = Actualizar detalles
Update hosting package = Actualizar planes de hospedaje
Update language installed! = La actualización del pack de lenguaje se ha efectuado correctamente !
Update order = Actualizar orden
Update password = Actualizar contraseña
Update plan = Actualizar plan
Update user = Actualizar usuario
Upload = Cargar
Upload file error! = Error en el archivo de carga!
Upload logo = Cargar logotipo
Use numeric ID = Use un ID numérico
Use other dir = Utilice otro directorio
Used = Usado
User (first and last) name = Nombre del usuario (nombre y apellidos)
User = Usuario
User account = Cuenta de usuario
User accounts = Cuentas de usuarios
User added = Usuario añadido
User added! = Usuario añadido!
User already exist ! = Usuario ya existe!
User already logged or session sharing problem! Aborting... = Problemas con la identificación del usuario o con la compartición de la sesión! Abortando...
User assign = Asignar usuario
User assignment = Asignación del usuario
User auth = Identificación de usuario
User data not updated! = Los datos del usuario no se han actualizado!
User data updated! = Datos del usuario actualizados!
User deleted = Usuario eliminado
User does not exist or you do not have permission to access this interface! = Usuario no existe o no tienes permiso para acceder a esta interfaz!
User does not exist! = Usuario no existe!
User language updated successfully! = Lenguaje del usuario fue actualizado correctamente!
user list is empty! = lista de usuarios está vacia!
User login (system) name = Identificación del usuario (sistema)
User name = Nombre de usuario
User name too long! = Usuario demasiado largo!
User not terminated! = Usuario no finalizado!
User password = Contraseña de usuario
User password updated successfully! = Contraseña del usuario fue actualizada correctamente!
User real (first and last) Name = Nombre real del usuario (nombre y apellidos)
User session was killed! = Sesion del usuario fue matada!
User sessions = Sesiones de usuarios
User terminated! = Usuario eliminado !
User type = Tipo de usuario
User updated = Usuario actualizado !
User was assigned to group  = Usuario asignado al grupo
User was assigned to group = Usuario asignado al grupo
User was deleted from group  = Usuario eliminado del grupo
User was disabled = El usuario está desactivado!
User was moved = Usuario movido
Username = Nombre de usuario
Users = Usuarios
Users list = Lista de usuarios
Users list is empty! = La lista de usuarios está vacía!
Very high = Realmente alto
VHCS - Admin - Email Marketing = VHCS - Administrador - Correo de contacto
VHCS - Admin - Manage custom menus = VHCS - Administrador - Gestionar menús personalizados
VHCS - Admin/Admin Log = VHCS - Administrador/Identificación Administrador
VHCS - Admin/Change Password = VHCS - Administrador/Modificación de la contraseña
VHCS - Admin/Change Personal Data = VHCS - Administrador/Modificación de los datos personales
VHCS - Admin/Internationalization = VHCS - Administrador/Internacionalización
VHCS - Admin/IP manage = VHCS - Administrador/Gestion de IPs
VHCS - Admin/Lostpw email setup = VHCS - Administrador/Instalación de email Lostpw
VHCS - Admin/Main Index = VHCS - Administrador/Indice principal
VHCS - Admin/Manage Sessions = Administrador/Gestionar Sesiones
VHCS - Admin/Manage Users = VHCS - Administrador/Gestionar usuarios
VHCS - Admin/Manage users/Add reseller = VHCS - Administrador/Gestion de usuarios/Añadir Distribuidor
VHCS - Admin/Manage users/Add User = VHCS - Administrador/Gestion de usuarios/Añadir usuario
VHCS - Admin/Manage users/Edit Reseller = VHCS - Administrador/Gestion de usuarios/Modificar Distribuidor
VHCS - Admin/Manage users/Edit User = VHCS - Administrador/Gestion de usuarios/Modificar Usuario
VHCS - Admin/Manage users/Email setup = VHCS - Administrador/Gestion de usuarios/Configurar correo
VHCS - Admin/Manage users/Reseller assignment = VHCS - Administrador/Gestion de usuarios/Asignar distribuidor
VHCS - Admin/Manage users/User assignment = VHCS - Administrador/Gestion de usuarios/Asignar usuario
VHCS - Admin/Reseller User Statistics = VHCS - Administrador/Estadísticas del distribuidor
VHCS - Admin/Server day stats = VHCS - Administrador/Estadísticas diarias del servidor
VHCS - Admin/Server statistics = VHCS - Administrador/Estadísticas del servidor
VHCS - Admin/Server Traffic Settings = VHCS - Administrador/Configurar el tráfico en el servidor
VHCS - Administrator/Add hosting plan = Administrador/Añadir plan de hospedaje
VHCS - Administrator/Edit hosting plan = Administrador/Modificar plan de hospedaje
VHCS - Administrator/Hosting Plan Management = Administrador/Gestion de planes de hospedaje
VHCS - Circular = VHCS - Circular
VHCS - Client : Support System: View Tickets = VHCS - Cliente : Sistema de Soporte: Ver Tickets
VHCS - Client/Add FTP User = VHCS - Cliente/Añadir usuario FTP
VHCS - Client/Add Mail User = VHCS - Cliente/Añadir usuario de correo
VHCS - Client/Add SQL Database = VHCS - Cliente/Añadir base de datos SQL
VHCS - Client/Add SQL User = VHCS - Cliente/Añadir usuario SQL
VHCS - Client/Add Subdomain = VHCS - Cliente/Añadir Subdominio
VHCS - Client/Change Language = Cliente/Cambiar lenguaje
VHCS - Client/Change Password = VHCS - Cliente/Modificar Contraseña
VHCS - Client/Change Personal Data = VHCS - Cliente/Modificar datos personales
VHCS - Client/Change SQL User Password = VHCS - Cliente/Modificar contraseña del usuario SQL
VHCS - Client/Create CatchAll Mail Account = VHCS - Cliente/Crear una cuenta de correo por defecto
VHCS - Client/Cronjob Manager = Cliente/Gestion de Tareas Programadas
VHCS - Client/Daily Backup = VHCS - Cliente/Copia de seguridad diaria
VHCS - Client/Domain Statistics = VHCS - Cliente/Estadísticas del dominio
VHCS - Client/Edit FTP Account = VHCS - Cliente/Modificar cuenta FTP
VHCS - Client/Enable Mail Auto Responder = VHCS - Cliente/Habilitar autocontestador de correo
VHCS - Client/Enable Mail Autoresponder = VHCS - Cliente / Autocontestador de correo activado
VHCS - Client/Execute SQL Query = VHCS - Cliente/Ejecutar petición SQL
VHCS - Client/Main Index = VHCS - Cliente/Indice Principal
VHCS - Client/Manage Domains = VHCS - Cliente/Gestionar Dominios
VHCS - Client/Manage Error Custom Pages = Cliente/Gestionar Paginas de Error
VHCS - Client/Manage SQL = VHCS - Cliente/Gestionar SQL
VHCS - Client/Manage Users = VHCS - Cliente/Gestionar Usuarios
VHCS - Client/Questions & Comments = VHCS - Cliente/Preguntas y Comentarios
VHCS - Client/Webtools = VHCS - Cliente/Herramientas Web
VHCS - Domain Statistics Data = VHCS - Datos Estadísticos del Dominio
VHCS - Domain/Details = VHCS - Dominio/Detalles
VHCS - Domain/Edit = VHCS - Dominio/Modificar
VHCS - Manage Domain Alias/Edit Alias = VHCS - Gestion de Alias de Dominio/Modificar Alias
VHCS - Manage Domain/Alias = VHCS - Gestion de Dominio/Alias
VHCS - Manage Mail and FTP / Edit mail account = VHCS - Gestion de Correo y FTP/Modificar cuenta de correo
VHCS - Reseller : Support System: View Tickets = VHCS - Distribuidor : Sistema de Soporte: Ver tikets
VHCS - Reseller statistics = VHCS - Distribuidor - Estadísticas
VHCS - Reseller/Add hosting plan = VHCS - Distribuidor/Añadir plan de hospedaje
VHCS - Reseller/Change Password = VHCS - Distribuidor/Modificar Contraseña
VHCS - Reseller/Change Personal Data = VHCS - Distribuidor/Modificar datos personales
VHCS - Reseller/Edit hosting plan = VHCS - Distribuidor/Modificar plan de hospedaje
VHCS - Reseller/Lostpw email setup = VHCS - Distribuidor/Instalación de Email Lostpw
VHCS - Reseller/Main Index = VHCS - Distribuidor/Indice Principal
VHCS - Reseller/Order details = VHCS - Distribuidor/Detalle Orden
VHCS - Reseller/Order email setup = VHCS - Distribuidor/Instalación Email Orden
VHCS - Reseller/Order management = VHCS - Distribuidor/Gestor de Ordenes
VHCS - Reseller/Order settings = VHCS - Distribuidor/Configuración Ordenes
VHCS - Support system - New ticket = VHCS - Sistema de Soporte - Nuevo tiket
VHCS - Update hosting plan = Actualizar plan de hospedaje
VHCS - User/Add user = VHCS - Usuario/Añadir usuario
VHCS - User/Add user(step2) = VHCS - Usuario/Añadir usuario(paso 2)
VHCS - Users = VHCS - Usuarios
VHCS - Users/Add user = VHCS - Usuarios/Añadir usuario
VHCS - Users/Edit = VHCS - Usuario/Modificar
VHCS - Virtual Hosting Control System = VHCS - Virtual Hosting Control System
VHCS Admin / System Tools / Server Status = VHCS Administrador / Herramientas del Sistema / Estado del servidor
VHCS Client : Add Alias = VHCS Client : Añadir Alias
VHCS Control Panel = Panel de Control VHCS
VHCS debugger = VHCS Depuración
VHCS Reseller : Add Alias = VHCS Distribuidor : Añadir Alias
VHCS updates = VHCS Actualizaciones
View = Ver
view aliases = ver alias
View details = Ver detalle
View hosting plan = Ver plan de hospedaje
View support ticket = Ver el ticket de soporte
Vital system info = Información vital del sistema
wait to be added = Procesando agregar...
wait to be deleted = Procesando eliminación...
wait to be enabled = procesando activación...
wait to be modified = Procesando modificación...
wait to be suspended = procesando suspensión...
Warning traffic [MB] = Alerta de tráfico [MB]
Warning traffic is bigger then max traffic! = Alerta de tráfico mas grande que el máximo tráfico
Web & E-Mail Support = Soporte Web & E-Mail
WEB = Transferencia web
Web in = Web activada
Web out = Web desconectada
Web traffic = Tráfico web
Web<br>traffic = Tráfico web
Webmail = Correo web
Webspace = Espacio Web
Webstatistics = Estadísticas web
Webtools = Herramientas de Internet
Weekday(s): = Día de semana(s):
which has limits for the <b> = Cuales son los límites para <b>
Which has limits for the <b> = Cuales son los límites para <b>
Wildcards as % and ? are not allowed! = Comodines como % y ? no son permitidos!
Wrong data input! = Los datos insertados no son correctos !
Wrong domain ID! = Error en la ID del Dominio!
Wrong domain name syntax! = El nombre del dominio no es correcto !
Wrong IP number! = La IP no es correcta !
Wrong order ID! = EL Id de orden no es correcto !
Wrong subdomain syntax! = Error en la sintaxis del subdominio!
Wrong username! = El usuario no es correcto !
Year = Año
Year: = Año:
Yellow = Amarillo
yes = Sí
Yes = Sí
You are exceeding SQL database limit! = Ha sobrepasado el límite de bases de datos MySQL permitidas!
You Are Exceeding Your Alias Limit! = Ha sobrepasado el límite de Alias permitidos!
You are exceeding your disk limit! = Usted ha excedido el límite permitido de espacio en disco !
You are exceeding your FTP account limit! = Ha sobrepasado el  límite de  cuentas FTP permitidas!
You are exceeding your mail account limit! = Ha sobrepasado el límite de cuentas de correo permitidas!
You are exceeding your subdomain limit! = Ha sobrepasado el límite de subdominios permitidos!
You are exceeding your traffic limit! = Uste ha sobrepasado el límite de tráfico permitido !
You are exceeding your UNLIMITED disk limit! = Ha sobrepasado el límite de su espacio en  disco!
You are exceeding your UNLIMITED traffic limit! = Ha sobrepasado el límite de tráfico permitido !
You can not move <b> = Usted no puede mover
You can not protect area without selected group(s) = No puede proteger un area sin seleccionar un grupo(s)
You can not protect area without selected usre(s) = No puede proteger un area sin seleccionar un usuario(s)
You can upload only images! = Puede subir imagenes solamente!
You can upload only text files! = Puede subir archivos de textos solamente!
You do not have new orders! = No tiene nuevas ordenes!
You do not have permission to access this interface! = No tiene permiso para acceder a esta interfaz!
You do not have protected areas = No tiene areas protegidas
You have = Usted tiene
You have alias limit!<br>You can Not Add User With Unlimited Alias Number! = Tiene limitado los alias!<br>No puede Añadir Usuarios con alias ilimitados!
You have been reached your domain limit.<br>You can not add more domains !  = Ha sobrepasado el límite de dominios!<br>Usted no puede añadir mas dominios!
You have disabled SQL databases for this user!<br>You can not have SQL users here! = MySql no está disponible para este cliente!<br>Usted no dispone de ningún usuario SQL en ete momento!
You have disk limit!<br>You can not add user with unlimited disk number! = Existe un límite para el espacio en disco!<br>Usted no puede crear usuarios con espacio ilimitado en disco!
You have FTP account limit!<br>You can not Add User With Unlimited FTP Accunt Number! = Existe un límite para las cuentas FTP!<br>Usted no puede añadir clientes con ilimitadas cuentas FTP!
You have mail account limit!<br>You can not add user with unlimited mail accunt number! = Existe un límite para crear cuentas de correo!<br>Usted no puede crear usuarios con ilimitadas cuentas de correo!
You have no alias records. = No tiene alias registrados.
You have no custom menus. = No tiene menu personalizados.
You have no groups ! = No hay grupos !
You have no groups! = No hay grupos!
You have no hosting plans. Please add first hosting plan or contact your system administrator. = No tiene planes de hospedaje. Por favor añadir primero planes de hospedaje o contactarse con su administrador.
You have no new support questions! = No hay nuevas preguntas de soporte!
You have no support tickets. = No tiene soporte de tickets.
You have no user records. = No tiene usuarios registrados.
You have no users ! = No hay usuarios!
You have no users! = No tiene usuarios!
You have no users. = No tiene usuarios.
You have SQL database limit!<br>You can not add user with unlimited SQL database number! = Tiene limite de base de datos!<br>No puede añadir usuarios con base de datos ilimitadas!
You have SQL user limit!<br>You can not add user with unlimited SQL users! = Ha sobrepasado el límite de usuarios SQL!<br>Usted no puede añadir mas clientes con usuarios SQL ilimitados!
You have subdomain limit!<br>You can not add user with unlimited subdomain number! = Existe un límite para crear subdominios!<br>Usted no puede crear usuarios con subdominios ilimitados!
You have traffic limit!<br>You can not add user with unlimited traffic number! = Usted tiene limitado el tráfico!<br>Usted no puede añadir usuarios con tráfico ilimitado!
You must assign at least one IP number for a reseller! = Debe asignar como mínimo una IP al distribuidor!
You send email to your users successfully! = Se ha enviado emails a sus usuarios correctamente!
Your Chart = Tu gráfico
Your logo was successful uploaded! = Tu logo ha sido subido correctamente!
Your message = Su mensaje
Your message was sent! = Tu mensaje ha sido enviado!
Your order = Tu orden
Your Own Domain = To dominio propio
Your request for hosting pack update was added successfully = Tu solicitud de actualización del plan de hospedaje ha sido añadida correctamente!
Your request for hosting pack update was removed successfully = Tu solicitud de actualización de plan de hospedaje ha sido eliminada correctamente!
Zip / Postal code = Código Postal
Zip/Postal code = Código Postal